    111111111111
1111010100000001
100001000011111
10000100001
10000100001
10000000001
 10000000001
 10000000001
 10000100001
 10P01111001
 11111111111
